#####################
#p....s...#........p#
#.##.####.#.####.##.#
#.##.####.#.####.##.#
#...................#
#.##.#.#######.#.##.#
#....#....#....#....#
####.####.#.####.####
####.#.........#.####
####.#.###_###.#.####
####.#.#P____#.#.####
#....s.#_____#.b...s#
####.#.#B__C_#.#.####
####.#.#######.#.####
####.#....f....#.####
####.#.#######.#.####
#.........#.........#
#.###.###.#.###.###.#
#...#.....J.....#...#
###.#.#.#####.#.#.###
#p....#...#...#....p#
#.#######.#.#######.#
#..................s#
#####################
F

Caracteres:
F - fin del archivo

# - pared
_ - celda vacia

. - pac dot
p - power pellet
f - fruta
s - speed potion
b - bomba

J - jugador
B - Blinky
P - Pinky
I - Inky
C - Clyde

t - teletransportador




