#####################
#p....s...#........p#
#.##.####.#.####.##.#
#.##.####.#.####.##.#
#...................#
#.##.#.#######.#.##.#
#....#....#....#....#
####.####.#.####.####
####.#.........#.####
####.#.###_###.#.####
####.#.#P___B#.#.####
#....s.__###__.b...s#
####.#.#I___C#.#.####
####.#.###_###.#.####
####.#....f....#.####
####.#.#######.#.####
#.........#.........#
#.###.###.#.###.###.#
#...#.....J.....#...#
###.#.#.#####.#.#.###
#p....#...#...#....p#
#.#######.#.#######.#
#..................s#
#####################
F

Caracteres:
F - fin del archivo

# - pared
_ - celda vacia

. - pac dot
p - power pellet
f - fruta
s - speed potion
b - bomba

J - jugador
B - Blinky
P - Pinky
I - Inky
C - Clyde

t - teletransportador




