#####################
#..#..#...#.........#
#.#.#..O#..O###.#####
#.....#...#.#.......#
#.#.#...#...#.#.#.#.#
#.....#...#.#.......#
#.########..#########
#O.........#........#
#...####..#...#.#.#.#
#.#..##..#..#.#.#.#.#
#.##....#..##.#.#.#.#
#.####.##.###.#.#.#.#
#.#.....#...#.#.#.#.#
#.#...#..##.#.#.#.#.#
#...#..#..#.#.#.#.#.#
#.###..##.#.#O#O#O#.#
#...#######.#.#.#.#.#
#.#.......#.#.#.#.#.#
#.#######.#.#.#.#.#.#
#.#.....#.#.#.#.#.#.#
#...#.#...#.#.#.#.#.#
#.###.###.#.#.#.#.#.#
#........##.........#
#####################
F