#####################
#..#..#...#.........#
#.#.#...#...###.#####
#.....#...#.#.......#
#.#.#...#...#.#.#.#.#
#.....#...#.#.......#
#.########..#########
#..........#........#
#...####..#...#.#.#.#
#.#..##..#..#.#.#.#.#
#.##....#..##.#.#.#.#
#.####.##.###.#.#.#.#
#.#.....#...#.#.#.#.#
#.#...#..##.#.#.#.#.#
#...#..#..#.#.#.#.#.#
#.###..##.#.#.#.#.#.#
#...#######.#.#.#.#.#
#.#.......#.#.#.#.#.#
#.#######.#.#.#.#.#.#
#.#.....#.#.#.#.#.#.#
#...#.#...#.#.#.#.#.#
#.###.###.#.#.#.#.#.#
#........##.........#
#####################
F