#####################
#.........#.....#...#
#.#####.#.#.###.#...#
#.#...#.#.#.###.....#
#.#.#.#.#.#.###.#...#
#.#.#.#.#.#.....#...#
#.#.#.#.#.#.#.#.#####
#.#.#...#.#.#.......#
#.#.#####.#.###.###.#
#.#.......#.#...#...#
#.#######.....#.#.###
#.........#.#.#.#.###
###.#.#.#.#.........#
###.........#######.#
#...#.#.#.#.......#.#
#.#.......#.#####.#.#
#.###.###.#.#...#.#.#
#......##.#.#.#.#.#.#
##.###.##.#.#.#.#.#.#
#...#...#.#.#.#.#.#.#
#.#.#.#.#.#.#.#...#.#
#.#.#.#.#.#.#.#####.#
#.....#...#.........#
#####################
F